1111111111111
1E000P0000P01
1100011111111
1P11111111111
1111111111111
