1111111111111
1E00000000001
1C00011111111
1P11111111111
1111111111111
