111111111
100110C01
10P010001
10C111E01
100000001
111111111
